8
105
0 1 0 2 3 4 3 5 0 1 2 3 4 3 4 3 4 3 4 3 5 6 0 6 0 1 6 0 1 1 6 0 6 6 6 1 0 6 1 2 3 5 1 7 8 8 8 8 8 8 8 8 8 8 8 8 8 8 8 8 8 8 8 8 8 8 8 8 8 8 8 8 8 8 8 8 8 8 8 8 8 8 8 8 8 8 8 8 8 8 8 8 8 8 8 8 8 8 8 9 6 6 6 6 10 
11 12 13 14 15 16 15 17 13 12 14 15 16 15 16 15 16 15 16 15 17 0 11 6 13 12 0 11 18 18 6 13 1 1 6 18 13 6 12 14 15 17 18 19 20 20 20 20 20 20 20 20 20 20 20 20 20 20 20 20 20 20 20 20 20 20 20 20 20 20 20 20 20 20 20 20 20 20 20 20 20 21 22 22 22 22 22 22 22 22 22 22 22 22 22 22 22 22 22 23 24 25 26 27 10 
12 28 29 30 31 32 31 28 29 29 33 34 35 36 37 34 32 31 37 36 28 38 39 40 6 1 13 12 41 38 29 29 42 12 6 13 6 28 29 33 36 29 43 44 44 44 44 44 44 44 44 44 44 44 44 44 44 44 44 45 45 45 45 45 44 44 44 44 44 45 45 45 45 45 45 45 45 45 44 44 45 46 20 20 20 20 20 20 20 20 20 20 20 20 20 20 20 20 20 20 47 48 49 50 10 
6 51 52 53 51 53 51 51 52 52 52 53 51 52 52 53 53 51 52 52 51 52 52 53 54 55 54 54 51 52 52 52 53 54 54 54 54 51 52 52 52 52 53 56 56 57 57 57 57 57 57 57 57 57 57 57 57 57 56 44 44 44 44 44 56 57 57 57 57 45 44 44 45 45 45 45 45 44 56 57 45 44 44 45 45 45 45 45 45 45 45 45 45 45 44 44 44 44 45 45 58 59 60 61 10 
62 57 57 57 57 56 56 56 57 57 57 57 57 56 56 57 57 57 57 57 57 57 57 57 63 64 64 65 57 57 57 57 57 63 64 64 65 57 57 57 57 57 57 57 57 66 66 66 66 66 67 67 67 67 67 67 67 66 57 57 57 57 57 57 57 66 66 66 67 44 56 57 45 44 44 45 45 57 57 66 45 57 56 44 44 44 44 45 45 45 45 45 44 44 57 57 57 57 44 45 68 69 70 71 10 
72 66 66 66 66 57 57 57 67 66 66 67 66 57 57 66 66 66 66 66 73 73 73 66 74 75 75 72 66 66 66 66 66 74 75 75 72 66 66 66 66 66 66 66 66 66 66 73 73 66 57 57 57 57 57 57 57 66 66 66 67 67 66 67 67 66 73 66 57 57 57 66 45 57 56 44 44 66 66 73 45 66 57 57 57 57 57 45 45 44 44 45 57 57 66 73 73 76 57 44 77 78 60 61 10 
79 80 80 80 81 82 82 82 83 67 67 84 85 82 82 86 80 81 87 67 67 88 82 86 89 75 75 79 80 80 80 80 80 89 75 75 79 80 81 82 82 82 82 87 67 67 67 88 82 85 82 82 82 87 67 67 67 67 67 67 57 57 66 57 57 66 66 66 66 66 66 66 45 67 57 57 57 66 67 66 45 66 66 66 66 67 67 44 45 57 57 45 66 66 67 67 67 67 67 56 90 91 92 61 10 
93 93 93 93 93 93 93 93 94 95 95 96 93 93 93 93 93 93 94 95 95 96 93 93 93 93 93 93 93 93 93 93 93 93 93 93 93 93 93 93 93 93 93 94 95 95 95 96 93 93 93 93 93 94 95 97 98 98 98 98 99 99 99 99 99 99 99 99 99 99 99 99 100 98 99 99 99 99 98 99 100 99 99 99 99 98 98 98 100 99 99 100 99 99 98 98 98 98 98 98 98 101 102 102 10 


old tilemap:
5
35

1 1 1 1 1 1 1 1 1 1 1 1 1 1 1 1 1 1 1 1 1 1 1 1 1 1 1 1 1 1 0 0 0 0 0
2 2 2 2 2 2 2 2 2 2 2 2 2 2 2 2 2 2 2 2 2 2 2 2 2 2 2 2 2 2 2 2 2 0 0 
4 4 3 3 3 3 4 4 4 4 4 4 4 3 3 3 4 4 4 4 4 4 4 4 4 4 4 4 3 3 0 0 0 0 0
5 5 4 4 4 4 5 5 5 5 5 5 5 4 4 4 5 5 5 5 0 0 0 0 0 0 0 0 0 0 0 0 0 0 0
5 5 5 5 5 5 5 5 5 5 5 5 5 5 5 5 5 5 5 5 5 5 5 5 5 5 5 5 5 5 5 5 5 5 0 

1: tree
2: grassland
2: dirt top
4: dirt bottom
5: seases

